{
  "cols": 5,
  "rows": 14,
  "cells": {
    "0": 1,
    "5": 2,
    "9": 32,
    "10": 3,
    "11": 7,
    "13": 23,
    "14": 33,
    "15": 4,
    "16": 8,
    "17": 16,
    "18": 24,
    "19": 34,
    "20": 5,
    "21": 9,
    "22": 17,
    "23": 25,
    "24": 35,
    "25": 6,
    "26": 10,
    "27": 18,
    "28": 26,
    "29": 36,
    "31": 11,
    "32": 19,
    "33": 27,
    "34": 37,
    "36": 12,
    "37": 20,
    "38": 28,
    "39": 38,
    "41": 13,
    "42": 21,
    "43": 29,
    "44": 39,
    "46": 14,
    "47": 22,
    "48": 30,
    "49": 40,
    "51": 15,
    "53": 31,
    "54": 41,
    "59": 42,
    "64": 43
  }
}