{
  "cols": 4,
  "rows": 5,
  "cells": {
    "0": "rl01",
    "1": "rl02",
    "2": "rl03",
    "3": "rl04",
    "4": "rl05",
    "5": "rl06",
    "6": "rl07",
    "7": "rl08",
    "8": "rl09",
    "9": "rl10",
    "10": "rl11",
    "11": "rl12"
  }
}