{
  "rm01": {
    "cols": 4,
    "rows": 5,
    "cells": {
      "0": "rl01",
      "1": "rl02",
      "2": "rl03",
      "3": "rl04",
      "4": "rl05",
      "5": "rl06",
      "6": "rl11",
      "7": "rl12",
      "8": "rl09",
      "9": "rl10",
      "10": "rl07",
      "11": "rl08"
    }
  }
}